##########
#?      ##
#### #####
#$##  ####
# ### ####
# #   ####
#   ######
### ######
###    ###
##########